40
32
1111000011111111111111111111111111111111
1111000011111111111111111111111111111111
1111000000000000110001111110000000000111
1111110111111000111001111110000000000011
1111110111111000000000000000111100000000
1101110000011000001110000000111100000000
1100000000011000011111000011111111111111
1100001111111000011111000011111111111111
1100001111111000011111000011111111111111
1100001111110000011111000011111111111111
1101001111100110001111000001111101111011
1101000001101111001111000000111101111011
1101000001101111001111000000111101111011
1111000001100110001111000000111100000011
1111000001100000011111000000000000000011
1111111111111000011111000111111110000111
1111111111111000011111000111111110000111
1111100000000000011111000111111100000111
1111100000000000011111000111111001100011
1111100011111100111111000111111011110011
1111100011111100011111000100011011110011
1111100011111100000000000000000001100011
1111000011111100011111000000000000000111
1111000000000000011111011111111110000111
1111000000000000011111011111111110000111
1111000000000000011111011110000000100011
1111100000000111111111011110111100000011
1111100011110111111111000000111110101011
1111100011110000111111000001111100000011
1111100011110000111111111111111100100011
1110000011111000011111111111111111111111
1111000011111111111111111111111111111111
